W3 -- -- -- -- -- -- --
s1 -- -- -- -- -- -- --
s1 -- -- -- -- -- -- --
s1 -- -- -- -- -- -- --
s1 -- -- -- -- -- -- --
s1 -- -- -- -- -- -- --
b1 s2 s2 s2 s2 s2 s2 w4

W3 s2 -- -- -- -- -- --
b1 t3 s2 s2 s2 s2 s2 b3
b2 b4 -- -- -- -- -- s1
s1 -- -- -- -- -- -- s1
s1 -- b2 b3 -- -- b2 b4
s1 w2 b4 b1 s2 s2 b4 --
b1 s2 s2 s2 s2 s2 s2 w4