W3 -- -- -- -- -- --
s1 -- -- -- -- -- --
s1 -- -- -- -- -- --
s1 -- -- -- -- -- --
s1 -- -- -- -- -- --
s1 -- -- -- -- -- --
b1 s2 s2 s2 s2 s2 w4