W3 -- -- -- -- -- -- --
s1 -- -- -- -- -- -- --
s2 -- -- -- -- -- -- --
s3 -- -- -- -- -- -- --
s4 -- -- -- -- -- -- --
s2 -- -- -- -- -- -- --
b1 s1 s2 s2 s3 s3 s2 w4

W3 s2 -- -- -- -- -- --
s1 -- -- -- -- -- -- --
b1 t3 s2 s2 s1 s1 s2 b2
b2 b4 -- -- -- -- -- s1
s2 -- -- -- -- -- -- s2
s1 -- b2 b4 -- -- b2 b2
s2 w2 b3 b4 s2 s2 b1 --
b4 s2 s2 s2 s2 s2 s3 w2